...........................................
............######.........................
...........S######.........................
.......###########.........................
.......####################................
.......###########G.....####...............
.......###########...#..####...............
.......###########......####...............
.......######...........####...............
.......######...........####...............
........#####..............................
...........................................
...........................................
...........................................
...........................................
...........................................
...........................................
...........................................
...........................................
...........................................
...........................................
...........................................
...........................................
...........................................
...........................................